# Special countries..
#REB = "countries/Rebels.txt"
#PIR = "countries/Pirates.txt"
#NAT = "countries/Natives.txt"

# Freljord
AVA = "countries/Avarosa.txt"
FRE = "countries/Freljord.txt"
FRO = "countries/Frostguard.txt"
HEB = "countries/Hearthborne.txt"
ICE = "countries/IceChildren.txt"
SER = "countries/Seryldian.txt"
TRO = "countries/Troll.txt"

# Ionia
ION = "countries/Ionia.txt"
NIN = "countries/Ninja.txt"
VAS = "countries/Vastaya.txt"

# Noxus
BAS = "countries/Basilich.txt"
DEL = "countries/Delverhold.txt"
KIL = "countries/Kilgrove.txt"
NOX = "countries/Noxus.txt"

# Shurima
NAS = "countries/Nashramae.txt"
SHA = "countries/Shakkal.txt"
SHU = "countries/Shurima.txt"

# Others
BIL = "countries/Bilgewater.txt"
DEM = "countries/Demacia.txt"
IXT = "countries/Ixtal.txt"
PIL = "countries/Piltover.txt"
SIS = "countries/ShadowIsles.txt"
TAR = "countries/Targon.txt"
VOI = "countries/Void.txt"
ZAU = "countries/Zaun.txt"
